


11111111
1P00C001
1C0000E1
11111111
