111111
1EPCC1
1CCC01
1EEE01
111111