11111111
1P00C001
1C0000E1
10000001
11111111